20 20
o o o o o o o s m m s s s s s s s s o o
o o o o o s s s s m m m s s s f f s s o
o s o o s s s s s s s m m s f f f s s o
s s o o s s f s s s s s s s f f s s s o
s s o s s s f f f s s s s s f s s o o o
s s s s s f f f f s s m m s s s s o o o
s s s s s f f f f f s m m s s s s s o o
s s s s s s s f f s s m m s s s s s o o
s s s s o o s s s s s s m s s s s o o o
s s s o o o o o o s s s s s s s o o o s
s o o o o o o o s s s s s s o o o s s s
s o o o s o o s s s s s s s s o o o s s
s s o o s s o s s f f f f s s s o o o o
s s s s s s s s f f s f f s s s s o o o
s s s s s s s s s s s f s s s s s s o o
s s s s s s s s s s s s s s s s s s o o
s s s s s s s s s s s s s m m s s s s o
s s m m s s s s s s s s s s m s s s s o
s m m m m m s s s s s s s s m m m m m o
s s s s s m m s s s s s s s s s m m m m
